NO ./textures/xpm_files/brick_wall.xpm 
SO ./textures/xpm_files/grey_wall.xpm 
EA ./textures/xpm_files/brick_wall.xpm 
WE ./textures/xpm_files/brick_wall.xpm 
F 255, 100, 10
C 0, 200, 200






1111                       1111
10E1                       1001
1001                       1001
1101                       1001
1001                       1001
1001                       1001
1001                       1001
1001                       1001
1001                       1001
1001                       1001
1001                       1001
1001                       1001
1001                       1001
1001                       1001
1001                       1001
1001                       1001
1001                       1001
1001                       1001
1001                       1001
1001                       1001
1001                       1001
1001                       1001
1001                       1001
1001                       1001
1001                       1001
1001                       1001
1001                       1001
1001                       1001
1001                       1001
1001                       1001
1001                       1001
1001                       1001
1001                       1001
1001                       1001
1001                       1001
1001                       1001
1001                       1001
1001                       1001
1001                       1001
1001                       1001
1001                       1001
1001                       1001
1001                       1001
1001                       1001
1001                       1001
1001                       1001
1001                       1001
1001                       1001
1001                       1001
1001                       1001
1001                       1001
1001                       1001
1001                       1001
1001                       1001
1001                       1001
1001                       1001
10011111111111111111111111110011
10000000000000000000000000000001
10000000000000000000000000000001
10000000000000000000000000000001
11111111111111111111111111111111
