
NO ./textures/xpm_files/wall-design.xpm
SO ./textures/xpm_files/wall-design.xpm
EA ./textures/xpm_files/wall-design.xpm
WE ./textures/xpm_files/wall-design.xpm
F 255,255,255
C 255,255,255

1111111111111111111
1000000000000000001
1000000000000000001
1000000000000000001
1000000000111000001
1000000000111000001
1000000000111000001
1000000000000000001
10000000N0000000001
1000000000000000001
1111111111111111111
